+French
Croissant: Flour (Dry Goods), Butter (Dairy). Optional: Chocolate (Confectionery)
Souffl√©: Flour (Dry Goods), Butter (Dairy), Eggs (Dairy). Optional: Chocolate (Confectionery)
Cassoulet: Beans (Dry Goods), Sausages (Pork/Charcuterie), Duck (Poultry). Optional: Pork shoulder (Pork/Charcuterie)
Ratatouille: Garlic (Allium), Tomatoes (Garden Vegetables), Zucchini (Garden Vegetables), Eggplants (Garden Vegetables). Optional: Herbs (Herbs/Leafy Greens)
Coq-au-vin: Chicken (Poultry), Bacon (Pork/Charcuterie), Wine (Liquid Goods), Mushrooms (Root Vegetables/Mushrooms). Optional: Pearl Onions (Allium)
Tartiflette: Potatoes (Root Vegetables/Mushroom), Onions (Allium), Bacon (Pork/Charcuterie), Gruyere (Dairy). Optional: Wine (Liquid Goods)
Bouillabaisse: Monkfish (Fish/Shellfish), Mussels (Fish/Shellfish), Fennel (Garden Vegetable), Garlic (Allium), Saffron (Spices). Optional: Potatoes (Root Vegetables/Mushrooms)

+Italian
Gelato: Cream (Dairy), Sugar (Confectionery). Optional: Hazelnuts (Dry Goods)
Saltimbocca: Veal scallops (Beef/Veal), Proscuitto (Pork/Charcuterie), Sage (Herbs/Leafy Greens). Optional: Wine (Liquid Goods)
Arancini: Arborio rice (Dry Goods), Mozzarella (Dairy), Peas (Garden Vegetable). Optional: Minced meat (Beef/Veal)
Pizza Margherita: Flour (Dry Goods), Mozzarella (Dairy), Tomatoes (Garden Vegetable), Basil (Herbs/Leafy Greens). Optional: Olive oil (Liquid Goods)
Linguine Alio e Olio: Flour (Dry Goods), Garlic (Allium), Olive oil (Liquid Goods), Parsley (Herbs/Leafy Greens). Optional: Lemon (Fruits)
Risotto ai Funghi: Arborio Rice (Dry Goods), Porcini (Root Vegetables/Mushrooms), Wine (Liquid Goods), Mascarpone (Dairy). Optional: Garlic (Allium)
Lasagne al Forno: Flour (Dry Goods), Mozzarella (Dairy), Tomatoes (Garden Vegetable), Minced meat (Beef/Veal), Garlic (Allium). Optional: Basil (Herbs/Leafy Greens)

+Japanese
Salmon Nigiri: Salmon (Fish/Shellfish), Rice (Dry Goods). Optional: Soy sauce (Liquid Goods)
Furutsu Sando: Flour (Dry Goods), Cream (Dairy), Strawberries (Fruits). Optional: Kiwi (Fruits)
Tonkotsu Ramen: Pork bones (Pork/Charcuterie), Wheat flour (Dry Goods), Eggs (Dairy). Optional: Spring onions (Allium)
Wagyu Tataki: Wagyu sirloin (Beef/Veal), Vinegar (Liquid Goods), Ginger (Root Vegetables/Mushroom). Optional: Sesame seeds (Dry Goods)
Gyoza: Flour (Dry Goods), Minced pork (Pork/Charcuterie), Chives (Allium), Cabbage (Herbs/Leafy Greens). Optional: Sesame oil (Liquid Goods)
Miso Soup: Bonito (Fish/Shellfish), Miso paste (Dry Goods), Tofu (Dairy), Spring onions (Allium). Optional: Shiitake (Root vegetables/Mushrooms)
Beef Sukiyaki: Beef sirloin (Beef/Veal), Cabbage (Herbs/Leafy Greens), Sake (Liquid Goods), Enoki (Root vegetables/Mushrooms), Wheat flour (Dry Goods). Optional: Tofu (Dairy)

+Indian
Naan: Flour (Dry Goods), Yogurt (Dairy). Optional: Garlic (Allium)
Palak Paneer: Spinach (Herbs/Leafy Greens), Paneer (Dairy), Garam Masala (Spices). Optional: Garlic (Allium)
Korma: Lamb cubes (Beef/Veal), Ghee (Dairy), Cumin (Spices). Optional: Spinach (Herbs/Leafy Greens)
Gulab Jamun: Milk (Dairy), Flour (Dry Goods), Sugar (Confectionery). Optional: Cardamom (Spices)
Samosas: Flour (Dry Goods), Potatoes (Root Vegetables/Mushroom), Peas (Garden Vegetables), Masala (Spices). Optional: Ginger (Root Vegetables/Mushrooms)
Vindaloo: Pork cubes (Pork/Charcuterie), Garlic (Allium), Vinegar (Liquid Goods), Cumin (Spices). Optional: Ginger (Root Vegetables/Mushrooms)
Tikka Masala: Chicken cubes (Poultry), Yogurt (Dairy), Masala (Spices), Tomatoes (Garden Vegetables), Cream (Dairy). Optional: Garlic (Allium)

+Mediterranean
Hummus: Chickpeas (Dry Goods), Olive oil (Liquid Goods). Optional: Tahini (Liquid Goods)
Dolma: Minced pork (Pork/Charcuterie), Rice (Dry Goods), Grape leaves (Herbs/Leafy Greens). Optional: Onions (Allium)
Baklava: Flour (Dry Goods), Honey (Confectionery), Pistachios (Dry Goods). Optional: Butter (Dairy)
Moussaka: Eggplant (Garden Vegetables), Minced lamb (Beef/Veal), Milk (Dairy), Onions (Allium). Optional: Cinnamon (Spices)
Shawarma: Beef sirloin (Beef/Veal), Lettuce (Herbs/Leafy Greens), Baharat (Spices), Garlic (Allium). Optional: Flour (Dry Goods)
Couscous: Couscous (Dry Goods), Whole chicken (Poultry), Carrots (Root Vegetables/Mushrooms), Turnips (Root Vegetables/Mushrooms). Optional: Saffron (Spices)
Paella: Rice (Dry Goods), Mussels (Fish/Shellfish), Shrimps (Fish/Shellfish), Peas (Garden Vegetables), Saffron (Spices). Optional: Garlic (Allium)

+South-East Asian
Satay: Chicken breast (Poultry), Soy sauce (Liquid Goods). Optional: Peanuts (Dry Goods)
Char Siu Bao: Flour (Dry Goods), Pork belly (Pork/Charcuterie), Five-spice (Spices). Optional: Spring Onions (Allium)
Pho: Beef bones (Beef/Veal), Star Anise (Spices), Rice flour (Dry Goods). Optional: Thai basil (Herbs/Leafy Greens)
Turon: Banana (Fruit), Brown sugar (Confectionery), Rice paper (Dry Goods). Optional: Jackfruit (Fruit)
Spring Roll: Rice paper (Dry Goods), Shrimp (Fish/Shellfish), Cilantro (Herbs/Leafy Greens), Cucumber (Garden Vegetables). Optional: Chives (Allium)
Duck Rice: Duck (Poultry), Rice (Dry Goods), Honey (Confectionery), Rice vinegar (Liquid Goods). Optional: Eggs (Dairy)
Pad Thai: Rice flour (Dry Goods), Tofu (Dairy), Shrimp (Fish/Shellfish), Eggs (Dairy), Spring onions (Allium). Optional: Peanuts (Dry Goods)

+Caribbean
Fried Plantains: Plantains (Fruit), Vegetable Oil (Liquid Goods). Optional: Sugar (Confectionery)
Jerk Chicken: Chicken Legs (Poultry), Allspice (Spices), Garlic (Allium). Optional: Vinegar (Liquid Goods)
Callaloo: Amaranth (Herbs/Leafy Greens), Okra (Garden Vegetables), Coconut Milk (Dairy). Optional: Onions (Allium)
Accra: Cod (Fish/Shellfish), Garlic (Allium), Eggs (Dairy), Cloves (Spices). Optional: Chili peppers (Garden Vegetables)
Goat Roti: Goat cubes (Beef/Veal), Flour (Dry Goods), Curry (Spices), Potatoes (Root Vegetables/Mushrooms). Optional: Garlic (Allium)
Griot: Pork shoulder (Pork/Charcuterie), Onions (Allium), Cloves (Spices), Parsley (Herbs/Leafy Greens). Optional: Chili pepper (Garden Vegetable)
Jambalaya: Shrimp (Fish/Shellfish), Rice (Dry Goods), Andouille (Pork/Charcuterie), Green Bell Pepper (Garden Vegetables), Pepper (Spices). Optional: Okra (Garden Vegetables)